1111111111111111111111
10000C0110000000000001
1001P000100000C0000001
1001000010000CCC000001
100100001000CCCCC00001
10010001000000C0000001
1001000100000000000001
1001000100000000C00001
1001000100000000000001
10010001000C000C000001
10010001000CCCCC000001
10010000100C000C000001
10010C0010000000000001
1100000001001111100001
10000C00000000EC000001
1111111111111111111111