1111111111111111111111111111111111111
1001P00010000000000000000000000000001
10010000100000000000000000CCCC0000001
1001000010000000000000000000000000001
1001000010000000000000C000000000000C1
100100001000000000000CCC0000000000001
10010000000000000000CCCCC000000000001
1001000000000000000CCCCCCC00000000001
1000000000000000000C00000000000000001
1000000000000000000110000000000000001
100000000000000001111110000000000C001
1001000000000001111111111000000000001
1001000010000111111111111110000000001
1001000010000000011111000000000000001
100100001000001111111111111000000C001
100100001000CCC0000000111111100000001
100100001000000000000111000000E000001
1CC1000010000000000000000000000000001
1111111111111111111111111111111111111