1111111111111111111111
1P00000110000C000P0001
100100001000000C000P01
110000001000000000P001
1E000CC000000000000001
1111111111111111111111