1111111111111111111111
1P00000110000C00000001
100100001000000C0000000001
1100000010000000000001
1E000CC000000000000000000001
1111111111111111111111