1111111111111111111111
10000C0110000000000001
1001P00010000000000001
1000000010011111000001
10000C00000000EC000001
1111111111111111111111