1111111111111111111111
1P00000110000000000001
1001000010000000000001
1100000010000000000001
1E00011110000000000001
1111111111111111111111