1111111111111111111111
1P01110110000C00000001
1001C1001000000C000001
1001E10010000000000001
100000C000000000000001
1111111111111111111111