1111111111111111111111
1P01110110000C00000001
1001E1001000000C000001
1111110010000000000001
10000CC000000000000001
1111111111111111111111
