1111111111111111111111
1P00000110000C00000001
100100001000000C000001
1100000010000000000001
11000CC000000000000001
1111111111111111111111