1111111111111111111111
1P00000110000C000000E1
100100001000000C000001
1100000010000000000001
1E000CC0000000000000E1
1111111111111111111111